###############
##           S#
##     #      #
##     #      #
#      #  G   #
#      #      #
#   #         #
#   #  #      #
#   #         #
#             #
#     #      ##
#     #       #
#             #
#S            # 
###############

